

11111111
1P000001
10000001
10000C01
10000001
11111111
