1111111111111111111111
1P1000000111100E000001
1010100001111000000001
101010000111100000C001
1010100001111000111111
1010100001111000000001
10001C0001111111111001
1000100000000000000001
100010000000000000C001
1111111111111111111111