

11111111
1PE00001
10000C01
11111111
