

1111111
1PECCC1
1000001
1111111

1111111
1PECCC1
1000001
1111111