111111111111111
101000PCE0001
1111111111111