1111111
1P00001
1111101
1E00001
1000001
1111101
1CC0001
1111111