1111111111111111
1P100001100E0001
1010100110000001
101010011000C001
1010100110111111
1010100110000001
10001C0111111001
1000100000000001
100010000000C001
1111111111111111